R 1500 1000

NO ./picture.xpm

SO ./picture.xpm

WE ./picture.xpm

EA ./picture.xpm

S ./picture.xpm

F 255,100,30

C 225,30,0




11111111111111111111111111111
10000000001100000000000000001
10110000011100000000000010001
10010000000000000000000100011
10110000011100000000000010001
10000000001100000111011110001
11110111111111011100000010001
11110111111111011101010010001
11000000110101011100000010001
10000000000000001100000010001
10000000000000001101010010001
11000000110101011111011110N01
11110111111101011111011110001
11111111111111111111111111111